################
#        #    E#
#        #     #
#        #     #
#        #     #
#              #
#           #  #
#    ##     #  #
#    #      #  #
#    #      #  #
 P   #  #   #  #
################